▄█▄♠♠♠♠♠♠▲▲▄█▄▲▲▲♠♠▲▲▲▄█▄▲♠♠♠▄█▄▲▲▲▲▲▲▲▲▲▲▲▲▲▲▲▲▲▲▲▲▲▲▲▲▲▲▲▲▲▲▲▲▲▲  ♠▲▲▲▲▲▲▲▲▲▲▲▲▲▲▲♠▲▲▲▲
♠╨ ♠  ♠ ▄█▄ ╨♠♠♠♠♠♠♠♠  ╨▲     ╨  ▲▲▲▲    ▲▲▲▲▲▲▲    ▲      ▲▲▲▲▲▲▲▲▲▲▲▲▲▲  ▲▲▲▲▲▲▲▲▲▲▲▲▲▲
♠ ▄█▄    ╨       ▲      ♠           ▄█▄      ♠          ♠        ♠ ▲▲▲▲▲▲▲▲▲▲▲▲▲▲▲▲ ♠▲▲▲▲
█▄ ╨                       ♠         ╨                      ▲             ♠▲▲▲▲▲▲▲▲▲▲▲▲▲▲
╨▲♠ ▄█▄     ♠                                                           ▲      ▲▲  ▲▲▲▲▲▲
♠▄█▄ ╨   ▄█▄                                                   ♠                   ♠  ▲▲▲
♠♠╨       ╨            ▄█▄                ♠                                     ▲      ▲▲
▲▲▄█▄ ♠                 ╨                                                             ▲▲▲
█▄♠╨     ▄█▄                                           ▄█▄                           ▲▲▲▲
╨ ♠♠   ▲  ╨                                             ╨                            ▲▲▲▲
▲ ♠▄█▄       ♠                                                                        ▲▲▲
▲▲  ╨ ▄█▄                               ▄█▄                               ♠            ▲▲
♠♠♠    ╨  ▄█▄                            ╨                                            ▲▲▲
█▄♠♠       ╨                                            ♠                              ▲▲
╨  ▄█▄   ♠                                                                              ▲
♠♠♠ ╨          ▄█▄                                                                       
♠▄█▄            ╨                                                                 ░░░░░░░
♠♠╨                                                                            ░░░░░░░░░░
♠♠♠    ▄█▄                                                                           ░░░░
▲▲      ╨                                                                                
▲▲ ▄█▄                                                        ▄█▄                       ▲
▲▲▲ ╨                                                          ╨                      ▲▲▲
▲▲▲▲       ▄█▄                                                                        ▲▲▲
▲▲▲▲▲       ╨                                                                        ▲▲▲▲
▲▲♠▲    ♠                                                                            ▲♠▲▲
▲▲▲▲                                                                           ♠    ▲▲▲▲▲
▲▲▲                 ▄█▄             ♠                         ▄█▄                   ▲▲▲♠▲
▲▲▲                  ╨                                         ╨                    ▲▲▲▲▲
▲▲                                                                                 ▲▲▲♠▲▲
▲▲     ▄█▄                ♠        ▄█▄                                             ▲▲▲▲▲▲
▲▲      ╨                           ╨                         ♠            ♠    ▲▲▲▲▲▲▲▲▲
▲▲▲                                              ▄█▄                           ▲▲▲▲♠  ▲▲▲
▲▲▲▲          ♠                                   ╨                           ▲▲▲▲▲▲▲▲▲▲▲
▲▲▲▲▲                                  ♠                               ▲▲▲▲▲▲▲▲▲▲▲▲▲▲▲▲▲▲
▲▲▲▲▲▲▲▲▲▲▲▲▲▲▲▲  ♠         ▲▲▲▲▲                  ▲▲▲▲▲▲▲▲▲▲▲▲▲▲▲   ▲▲▲▲▲▲▲▲▲♠♠   ▲▲▲▲▲▲
▲▲▲▲▲▲▲▲▲♠    ▲▲▲▲▲▲▲▲▲▲▲▲▲▲▲▲▲▲▲▲▲▲▲▲▲▲▲▲▲▲▲▲▲▲▲▲▲▲▲▲▲♠  ▲▲▲▲▲▲  ▲▲▲▲▲▲▲▲▲▲▲♠  ▲▲▲▲▲▲▲▲▲
▲▲▲▲▲▲▲▲▲▲▲▲▲▲▲▲▲▲▲▲▲▲▲▲▲▲▲▲▲▲▲▲▲▲▲▲▲▲▲▲▲▲▲▲▲▲▲▲▲▲▲▲▲▲▲▲▲▲▲▲▲▲▲▲▲▲▲▲▲▲▲▲▲▲▲▲▲▲▲▲▲▲▲▲▲▲▲▲▲

╔═════════════════════════════════════════╦═════════════════════════════════════════════╗
║                                         ║                                             ║
╚═════════════════════════════════════════╩═════════════════════════════════════════════╝