▄█▄═══════════════════════════════════╡ ░░░░ ╞═════════▲▲▲▲▲▲▲▲  ♠▲▲▲▲▲▲▲▲▲▲▲▲▲▲▲♠▲▲▲▲   
♠╨ ♠    ▄█▄                              ░░░░       ▲      ▲▲▲▲▲▲▲▲▲▲▲▲▲▲  ▲▲▲▲▲▲▲▲▲▲▲▲▲▲
♠ ▄█▄    ╨                               ░░░░░          ♠        ♠ ▲▲▲▲▲▲▲▲▲▲▲▲▲▲▲▲ ♠▲▲▲▲
█▄ ╨                                      ░░░░░             ▲             ♠▲▲▲▲▲▲▲▲▲▲▲▲▲▲
╨▲♠ ▄█▄     ♠                              ░░░░░                        ▲      ▲▲  ▲▲▲▲▲▲
♠▄█▄ ╨   ▄█▄                                ░░░░░              ♠                   ♠  ▲▲▲
♠♠╨       ╨                                   ░░░░░░                            ▲      ▲▲
▲▲▄█▄ ♠                                         ░░░░░                                 ▲▲▲
█▄♠╨     ▄█▄                                      ░░░░░░░                            ▲▲▲▲
╨ ♠♠      ╨                                         ░░░░░░                           ▲▲▲▲
▲ ♠▄█▄       ♠                                         ░░░░░░░░                       ▲▲▲
▲▲  ╨ ▄█▄                                                  ░░░░░░░░░                   ▲▲
♠♠♠    ╨  ▄█▄                                                  ░░░░░░░░               ▲▲▲
█▄♠♠       ╨                                                      ░░░░░░░░             ▲▲
╨  ▄█▄   ♠                                                          ░░░░░░░             ▲
║ ♠ ╨          ▄█▄                                                      ░░░░░░░░░        
║▄█▄            ╨                                                         ░░░░░░░░░░░░░░░
║ ╨                                                                            ░░░░░░░░░░
║      ▄█▄                                                                           ░░░░
║       ╨                                                                                
║  ▄█▄                                                                                  ╥
║   ╨                                                                                   ║
║          ▄█▄                                                                          ║
║           ╨                                                                           ║
║                                                                                       ║
║                                                                                       ║
║                                                                                       ║
║                                                                                       ║
║                                                                                       ║
║                                                                                       ║
║                                                                                       ║
║                                                                                       ║
║                                                                                       ║
║                                                                                       ║
║                                                                                       ║
║                                                                                       ║
╚══════════════════════════════════╡              ╞═════════════════════════════════════╝

╔═════════════════════════════════════════╦═════════════════════════════════════════════╗
║                                         ║                                             ║
╚═════════════════════════════════════════╩═════════════════════════════════════════════╝