▄█▄♠♠♠♠♠♠▲▲▄█▄▲▲▲♠♠▲▲▲▄█▄▲♠♠♠▄█▄▲▲▲▲▲▲▲▲▲)────(▲▲▲▲▲▲▲▲▲▲▲▲▲▲▲▲▲▲  ♠▲▲▲▲▲▲▲▲▲▲▲▲▲▲▲♠▲▲▲▲ 
♠╨ ♠  ♠ ▄█▄ ╨♠♠♠♠♠♠♠♠  ╨▲     ╨  ▲▲▲▲     ░░░░      ▲      ▲▲▲▲▲▲▲▲▲▲▲▲▲▲  ▲▲▲▲▲▲▲▲▲▲▲▲▲▲
♠ ▄█▄    ╨       ▲      ♠           ▄█▄    ░░░░         ♠        ♠ ▲▲▲▲▲▲▲▲▲▲▲▲▲▲▲▲ ♠▲▲▲▲
█▄ ╨                       ♠         ╨     ░░░░░           ▲             ♠▲▲▲▲▲▲▲▲▲▲▲▲▲▲ 
╨▲♠ ▄█▄     ♠                              ░░░░░                        ▲      ▲▲  ▲▲▲▲▲▲
♠▄█▄ ╨   ▄█▄                                ░░░░░              ♠                   ♠  ▲▲▲
♠♠╨       ╨            ▄█▄                    ░░░░░░                            ▲      ▲▲
▲▲▄█▄ ♠                 ╨                       ░░░░░                                 ▲▲▲
█▄♠╨     ▄█▄                                      ░░░░░░░                            ▲▲▲▲
╨ ♠♠   ▲  ╨                                         ░░░░░░                           ▲▲▲▲
▲ ♠▄█▄       ♠                                         ░░░░░░░░                       ▲▲▲
▲▲  ╨ ▄█▄                                                  ░░░░░░░░░                   ▲▲
♠♠♠    ╨  ▄█▄                                                  ░░░░░░░░               ▲▲▲
█▄♠♠       ╨                                                      ░░░░░░░░             ▲▲
╨  ▄█▄   ♠                                                          ░░░░░░░             ▲
♠♠♠ ╨          ▄█▄                                                      ░░░░░░░░░        
♠▄█▄            ╨                                                         ░░░░░░░░░░░░░░░
♠♠╨                                                                            ░░░░░░░░░░
♠♠♠    ▄█▄                                                                           ░░░░
▲▲      ╨                                                                                
▲▲ ▄█▄                                                                                  ▲
▲▲▲ ╨                                                                                 ▲▲▲
▲▲▲▲       ▄█▄                                                                        ▲▲▲
▲▲▲▲▲       ╨                                                                        ▲▲▲▲
▲▲♠▲    ♠                                                                            ▲♠▲▲
▲▲▲▲                                                                           ♠    ▲▲▲▲▲
▲▲▲                 ▄█▄             ♠                         ▄█▄                   ▲▲▲♠▲
▲▲▲                  ╨                                         ╨                    ▲▲▲▲▲
▲▲                                                                                 ▲▲▲♠▲▲
▲▲     ▄█▄                ♠        ▄█▄                                             ▲▲▲▲▲▲
▲▲      ╨                           ╨                         ♠            ♠    ▲▲▲▲▲▲▲▲▲
▲▲▲                                              ▄█▄                           ▲▲▲▲♠  ▲▲▲
▲▲▲▲          ♠                                   ╨                           ▲▲▲▲▲▲▲▲▲▲▲
▲▲▲▲▲                                  ♠                               ▲▲▲▲▲▲▲▲▲▲▲▲▲▲▲▲▲▲
▲▲▲▲▲▲▲▲▲▲▲▲▲▲▲▲  ♠         ▲▲▲▲▲                  ▲▲▲▲▲▲▲▲▲▲▲▲▲▲▲   ▲▲▲▲▲▲▲▲▲♠♠   ▲▲▲▲▲▲
▲▲▲▲▲▲▲▲▲♠    ▲▲▲▲▲▲▲▲▲▲▲▲▲▲▲▲▲▲▲▲▲▲▲▲▲▲▲▲▲▲▲▲▲▲▲▲▲▲▲▲▲♠  ▲▲▲▲▲▲  ▲▲▲▲▲▲▲▲▲▲▲♠  ▲▲▲▲▲▲▲▲▲
▲▲▲▲▲▲▲▲▲▲▲▲▲▲▲▲▲▲▲▲▲▲▲▲▲▲▲▲▲▲▲▲▲▲▲▲▲▲▲▲▲▲▲▲▲▲▲▲▲▲▲▲▲▲▲▲▲▲▲▲▲▲▲▲▲▲▲▲▲▲▲▲▲▲▲▲▲▲▲▲▲▲▲▲▲▲▲▲▲

╔═════════════════════════════════════════╦═════════════════════════════════════════════╗
║                                         ║                                             ║
╚═════════════════════════════════════════╩═════════════════════════════════════════════╝