▲▲▲▲▲   ▲▲▲▲▲▲▲▲▲▲▲  ▲▲♠▲▲▲▲▲▲▲▲▲▲▲▲▲▲▲ ░░░░ ▲▲▲▲▲▲  ▲▲▲▲▲▲▲▲▲▲▲▲  ▲▲▲▲▲▲▲▲▲▲▲▲▲  ▲▲▲▲▲▲▲
▲▲▲▲▲▲▲▲▲▲▲▲▲▲♠▲▲    ▲▲▲▲▲   ♠  ▲▲▲     ░░░░    ° ▲▲▲▲▲▲▲▲▲▲▲  ▲▲▲▲▲▲▲▲▲▲▲▲▲▲   ▲▲▲▲▲▲▲▲▲
▲▲▲▲▲▲♠   ▲▲▲▲▲▲▲▲▲▲▲▲  ▲▲▲▲▲           ░░░░           ▲▲▲▲▲▲▲▲▲▲▲▲▲    ▲▲▲▲▲▲▲▲▲▲▲  ▲▲▲▲
▲▲▲▲▲▲▲▲▲▲▲▲▲▲▲▲▲▲▲▲▲▲▲ °              ░░░░                   ▲▲▲▲▲▲▲▲▲▲▲▲▲ ▲▲▲▲▲▲▲▲▲ ▲▲▲
 ▲▲♠ ▲▲▲▲▲▲▲       ♠                   ░░░░                                    ▲▲▲▲▲▲▲ ▲▲
▲▲▲▲▲▲▲▲▲      ▲                        ░░░░                                      ♠♠▲▲ ♠♠
▲▲▲▲▲▲ ō                                 ░░░░                                    ♠♠ ♠▲▲▲♠
▲▲▲▲  ▲   ♠                              ░░░                                    ♠♠♠♠♠♠♠♠♠
▲▲▲▲                   ♠                  ░░░░                                  ♠♠  ♠♠♠♠♠
▲▲▲♠     ▲                               ░░░░░                                    ♠♠  ♠♠♠
▲▲▲▲▲                                   ░░░░░                                      ♠♠♠♠♠♠
▲▲▲▲     ♠      ♠                  ░░░░░░░░░                                      ♠♠  ♠♠♠
▲▲▲                           ░░░░░░░░░░░░                                         ♠♠♠♠♠♠
▲▲▲   ▲                  ░░░░░░░░░░░░░                                             ♠♠♠ ♠♠
▲▲                  ░░░░░░░░░░░░                                                    ♠♠♠♠♠
            ░░░░░░░░░░░░░░░░                                                         ♠♠♠♠
░░░░░░░░░░░░░░░░░░░░░░░                                                              ♠♠♠♠
░░░░░░░░░░░░░░░░░░                                                                  ♠♠ ♠♠
░░░░░░░░░░  °                                                                        ♠♠♠♠
                                                   ▄                                ♠♠♠ ♠
▲▲▲                                            ▄███▀█▄                              ♠♠ ♠♠
▲▲▲▲                                           │ │┌─┐│                               ♠♠♠♠
▲▲▲▲                                           └─┴┘▀└┘                              ♠♠ ♠♠
▲▲▲▲▲                                                                              ♠♠ ♠▲▲
▲▲▲▲▲                                                                               ♠♠▲▲▲
▲▲▲▲▲                                                                                ♠▲ ▲
▲▲▲▲▲▲                                                                             ♠ ▲▲▲▲
▲▲  ▲▲▲▲                                                                         ♠♠▲▲▲▲▲▲
▲▲▲▲▲▲▲                                                                           ▲▲▲▲▲▲▲
▲▲▲▲▲     ♠                                                                    ▲▲▲▲♠  ▲▲▲
▲▲▲  ▲▲▲▲            ♠                                                      ▲▲▲▲▲▲  ▲▲▲▲▲
▲▲▲▲▲  ▲▲▲▲▲▲                                                          ▲▲▲▲  ▲▲▲▲▲▲▲▲▲▲▲▲
▲▲▲  ▲▲▲▲▲▲▲▲▲▲▲▲              ♠                                   ▲▲▲▲  ▲▲▲▲▲▲▲▲▲  ▲▲▲▲▲
▲▲▲▲▲▲    ▲▲▲▲▲▲▲▲▲▲▲▲▲                                       ▲▲▲▲▲▲▲▲▲▲▲   ▲▲▲▲▲▲▲▲▲▲▲▲▲
▲▲▲▲▲▲▲▲▲  ▲▲▲▲▲▲▲▲▲▲▲▲▲▲▲▲▲▲▲▲▲▲▲▲   ▲▲▲▲▲▲▲▲▲▲▲▲    ▲▲▲▲▲▲▲▲▲▲▲▲▲▲▲▲▲▲▲▲▲   ▲▲▲▲▲▲▲▲▲▲▲
▲▲▲  ▲▲▲▲▲▲▲▲▲▲   ▲▲▲▲▲▲▲▲▲▲▲▲▲▲▲▲▲▲▲▲▲▲▲▲▲▲▲▲▲▲▲▲▲▲▲▲▲▲    ▲▲▲▲▲▲▲▲▲▲▲▲▲▲▲▲▲▲    ▲▲▲▲▲▲▲
▲▲▲▲▲▲▲▲▲▲▲▲▲  ▲▲▲▲▲▲    ▲▲▲▲▲▲▲▲▲▲▲▲▲▲▲▲▲▲▲▲▲▲▲▲   ▲▲▲▲▲▲▲▲▲  ▲▲▲▲▲▲▲▲▲▲▲▲▲▲▲ ▲▲▲▲▲▲▲▲▲▲

╔═════════════════════════════════════════╦═════════════════════════════════════════════╗
║                                         ║                                             ║
╚═════════════════════════════════════════╩═════════════════════════════════════════════╝