▲▲▲▲▲   ▲▲▲▲▲▲▲▲▲▲▲  ▲▲♠▲▲▲▲▲▲▲▲▲▲▲▲▲▲▲ ░░░░ ╞══════════════════════════════════════════╗
▲▲▲▲▲▲▲▲▲▲▲▲▲▲♠▲▲    ▲▲▲▲▲   ♠  ▲▲▲     ░░░░                                            ║
▲▲▲▲▲▲♠   ▲▲▲▲▲▲▲▲▲▲▲▲  ▲▲▲▲▲           ░░░░                                            ║
▲▲▲▲▲▲▲▲▲▲▲▲▲▲▲▲▲▲▲▲▲▲▲                ░░░░                                             ║
 ▲▲♠ ▲▲▲▲▲▲▲       ♠                   ░░░░                                             ║
▲▲▲▲▲▲▲▲▲      ▲                        ░░░░                                            ║
▲▲▲▲▲▲                                   ░░░░                                           ║
▲▲▲▲  ▲   ♠                              ░░░                                            ║
▲▲▲▲                   ♠                  ░░░░                                          ║
▲▲▲♠     ▲                               ░░░░░                                          ║
▲▲▲▲▲                                   ░░░░░                                           ║
▲▲▲▲     ♠      ♠                  ░░░░░░░░░                                            ║
▲▲▲                           ░░░░░░░░░░░░                                              ║
▲▲▲   ▲                  ░░░░░░░░░░░░░                                                  ║
▲▲                  ░░░░░░░░░░░░                                                        ║
            ░░░░░░░░░░░░░░░░                                                            ║
░░░░░░░░░░░░░░░░░░░░░░░                                                                 ║
░░░░░░░░░░░░░░░░░░                                                                      ║
░░░░░░░░░░                                                                              ║
                                                   ▄                                    ║
╥                                              ▄███▀█▄                                  ║
║                                              │ │┌─┐│                                  ║
║                                              └─┴┘▀└┘                                  ║
║                                                                                       ║
║                                                                                       ║
║                                                                                       ║
║                                                                                       ║
║                                                                                       ║
║                                                                                       ║
║                                                                                       ║
║                                                                                       ║
║                                                                                       ║
║                                                                                       ║
║                                                                                       ║
║                                                                                       ║
║                                                                                       ║
╚═══════════════════════════════════════════════════════════════════════════════════════╝

╔═════════════════════════════════════════╦═════════════════════════════════════════════╗
║                                         ║                                             ║
╚═════════════════════════════════════════╩═════════════════════════════════════════════╝