╔═════════════════╦═══════════════════════════════════════════════════╦═════════════════╗
║                 ║                                                °  ║                 ║
║  ▄  █  █  ▄  █  ║                                                   ║  ▄  █  █  ▄  █  ║
║                 ╩                                                   ╩                 ║
║                                                                                       ║
║  █  █  ▄  █  █                                                         █  █  ▄  █  █  ║
║                                                                                       ║
║                 ╦                                                   ╦                 ║
║  █  █  ▄  █  █  ║    °                                              ║  █  █  ▄  █  █  ║
♠♠                ║                                                   ║                 ║
♠♠♠════╣   ╠══════╝                                                   ╚══════╣   ╠══════╣
♠♠                                                                                      ║
♠♠♠                                                                                     ║
♠♠♠                                ╔══════╣   ╠══════╗                                  ║
♠♠♠♠                               ║                ┼║                                  ║
♠♠♠♠♠♠  ■  ■  ■     ■  ■  ■  ■     ║ ▄  █       ▄  █ ║                                  ║
♠♠♠♠♠♠                             ╩       ¡Ø¡       ╩                                  ║
♠♠♠♠                                       ╦═╦                                          ║
♠♠█  █     █  █  █  █        █  █    █  █  ┴▀┴  █  ▄                          °         ║
♠♠♠                                                                                     ║
♠♠♠♠                               ╦                 ╦                                  ║
♠♠♠  ▄  █     █  █     █  █  ▄  █  ║ █  █       ▄  ▄ ║                                  ║
♠♠                                 ║                 ║                                  ║
♠♠♠ ▲                              ╚══════╣   ╠══════╝                                  ║
♠▲▲                                                                                     ║
♠♠                                                                                      ║
♠══════╣   ╠══════╗                                                   ╔══════╣   ╠══════║
▲   ▲            ō║                                                   ║°                ║
♠▲    █  █  ▄  █  ║                                                   ║  ▄  █  █  ▄  █  ║
▲▲▲         ▲     ╩                                                   ╩                 ║
▲♠▲▲                                      ░                                             ║
▲▲▲▲  █  ▄  █  █                         ░░                              █  █  ▄  █  █  ║
▲  ▲▲▲▲▲▲          ▲                    ░░░░                                            ║
▲▲  ▲▲▲▲▲▲▲▲▲               ▲            ░░░                          ╦                 ║
▲▲▲▲▲♠  ▲▲▲▲▲▲▲▲▲▲▲▲▲▲                  ░░░░                          ║  █  █  ▄  █  █  ║
▲▲♠▲▲▲▲   ♠♠▲▲▲▲▲▲▲▲▲▲▲▲▲▲▲▲▲▲     ▲    ░░░░                          ║                 ║
▲▲▲▲▲▲▲▲▲▲▲▲▲▲▲▲▲▲   ▲▲♠♠▲▲▲▲▲▲▲▲▲▲▲▲▲▲ ░░░░ ╞════════════════════════╩═════════════════╝

╔═════════════════════════════════════════╦═════════════════════════════════════════════╗
║                                         ║                                             ║
╚═════════════════════════════════════════╩═════════════════════════════════════════════╝