♠♠♠♠♠♠♠♠♠♠♠♠    ♠♠♠♠♠♠♠♠♠♠♠♠♠♠♠♠▲▲▲▲▲▲▲▲▲▲▲▲▲▲▲▲▲▲▲   ▲▲▲▲▲▲▲▲▲▲▲▲▲▲▲▲▲▲▲  ▲▲▲▲▲▲▲▲▲ ▲▲▲▲
♠♠♠♠♠♠♠♠  ♠♠♠♠♠♠ ♠♠♠♠♠♠♠  ▲▲▲▲▲   ▲▲▲▲▲▲   ▲▲▲▲▲▲▲▲▲▲▲▲▲▲▲▲▲  ┼ ▲▲▲▲▲▲▲▲▲▲▲▲  ▲▲▲▲▲▲▲▲▲▲▲
♠♠ ♠♠♠♠ ♠♠♠   ō               ♠      ▲▲▲▲▲        ▲▲▲▲▲▲▲▲▲   ▲▲▲▲▲   ▲▲▲▲▲▲▲▲▲▲  ▲▲▲▲▲▲▲
♠♠  ♠♠♠♠                                     ♠       ▲▲▲                 ▲▲   ▲▲▲▲▲▲▲  ▲▲
♠♠♠♠♠                 ♠                   ░░░ ░                   ♠        ▲▲▲▲▲▲▲▲▲▲▲▲▲▲
♠♠♠♠♠                                      ░ ░░                                ▲▲▲▲  ▲▲▲▲
♠♠♠♠      ■    ■    ■    ■    ■    ■      ░░░░    ■     ■     ■     ■     ■       ▲▲▲▲▲▲▲
♠♠♠♠                                       ░░░░                                     ▲▲▲▲▲
♠♠♠   ■  ░░░░ ░░░░  ░░░░░ ░░░░  ░░░ ░░░░ ░░░░░░░░ ░░░░░░ ░░░░░░░ ░░░░░░░░░░░          ▲▲▲
♠♠          ░░░ ░░░░░░░ ░░░ ░░░░░░ ░░░░░░ ░░░░ ░░░░░░ ░░░░ ░░░ ░░░░░░ ░░░  ░░░░      ▲▲▲▲
♠♠                                         ░░░                                      ▲▲▲▲▲
♠♠        ■    ■    ■    ■    ■    ■      ░░░░    ■     ■     ■     ■     ■         ▲▲▲▲▲
♠♠♠                                        ░░░                                   ♠   ▲▲▲▲
♠♠♠                                       ░░░ ░                            ♠          ▲▲▲
♠♠♠♠                                       ░░░                                     ♠   ▲▲
♠♠♠♠♠♠                                     ░░░                                         ▲▲
♠♠♠♠♠♠    ■    ■    ■    ■    ■    ■      ░░░░    ■     ■     ■     ■     ■           ♠♠♠
♠♠♠♠                                       ░░ ░                                      ♠♠♠♠
♠♠       ░░░░ ░░░░  ░░░░░ ░░░░  ░░░ ░░░░ ░░░░░░░░ ░░░░░░ ░░░░░░░ ░░░░░░░░░░░   °     ♠ ♠♠
♠♠♠         ░░░ ░░░░░░░ ░░░ ░░░░░░ ░░░░░░ ░░░░ ░░░░░░ ░░░░ ░░░ ░░░░░░ ░░░  ░░░░       ♠♠♠
♠♠♠♠                                      ░░░░                                       ♠♠♠♠
♠♠♠       ■    ■    ■    ■    ■    ■      ░░░░    ■     ■     ■     ■     ■           ♠♠♠
♠♠                                        ░░░                                      ♠♠  ♠♠
♠♠♠ ▲                                     ░░░                                       ♠♠ ♠♠
♠▲▲                                      ░░░░░                                       ♠♠♠♠
♠♠                                       ░░ ░░                                       ♠ ♠♠
♠         ■    ■    ■    ■    ■    ■      ░░░░    ■     ■     ■     ■     ■           ♠♠♠
▲   ▲                                    ░░░░                          °              ♠♠♠
♠▲      ░░░░ ░░░░  ░░░░░ ░░░░  ░░░ ░░░░ ░░░░░░░░ ░░░░░░ ░░░░░░░ ░░░░░░░░░░░          ♠♠ ♠
▲▲▲        ░░░ ░░░░░░░ ░░░ ░░░░░░ ░░░░░░ ░░░░ ░░░░░░ ░░░░ ░░░ ░░░░░░ ░░░  ░░░░     ♠♠♠♠♠♠
▲♠▲▲                                    ░░░░░                                    ▲▲▲  ▲▲▲
▲▲▲▲      ■    ■    ■    ■    ■    ■     ░░░░     ■     ■     ■     ■       ▲▲▲▲▲▲▲▲▲▲▲▲▲
▲  ▲▲▲▲▲▲          ▲                    ░░░░                            ▲▲▲▲▲▲▲▲▲▲   ▲▲▲▲
▲▲  ▲▲▲▲▲▲▲▲▲               ▲            ░░░░░                    ▲▲▲▲▲▲▲▲▲   ▲▲▲▲▲▲▲▲▲▲▲
▲▲▲▲▲♠  ▲▲▲▲▲▲▲▲▲▲▲▲▲▲                  ░░░░░             ▲▲▲▲▲▲▲▲▲▲▲▲   ▲▲▲▲▲▲▲▲▲  ▲▲▲▲▲
▲▲♠▲▲▲▲   ♠♠▲▲▲▲▲▲▲▲▲▲▲▲▲▲▲▲▲▲     ▲     ░░░░    ▲▲▲▲▲▲▲▲▲▲▲▲▲▲▲  ▲▲▲▲▲▲▲▲▲▲▲▲▲▲▲▲  ▲▲▲▲▲
▲▲▲▲▲▲▲▲▲▲▲▲▲▲▲▲▲▲   ▲▲♠♠▲▲▲▲▲▲▲▲▲▲▲▲▲▲ ░░░░ ▲▲▲▲▲▲    ▲▲▲▲▲▲▲▲▲▲▲ ▲▲▲▲▲▲▲▲▲▲   ▲▲▲▲▲▲▲▲▲

╔═════════════════════════════════════════╦═════════════════════════════════════════════╗
║                                         ║                                             ║
╚═════════════════════════════════════════╩═════════════════════════════════════════════╝