╔═══════════════════════════════════════════════════════════════════════════════════════╗
║                                                                                       ║
║                                                                                       ║
║                                                                                       ║
║                                                                                       ║
║                                                                                       ║
║                                                                                       ║
║                                                                                       ║
║                                                                                       ║
║                                                                                       ║
║                                                                                       ║
║                                                                                       ║
║                                                                                       ║
║                                                                                       ║
║                                                                                       ║
║                                                                                       ║
║                                                                                       ║
║                                                                                       ║
║                                                                                       ║
║                                                                                       ║
║                                                                                       ║
║                                                                                       ║
║                                                                                       ║
║                                                                                       ║
║                                                                                       ║
║                                                                                       ║
║                                                                                       ║
║                                                                                       ║
║                                                                                       ║
║                                                                                       ║
║                                                                                       ║
║                                                                                       ║
║                                                                                       ║
║                                                                                       ║
║                                                                                       ║
║                                                                                       ║
╚═════════════════════════════════════╡      ╞══════════════════════════════════════════╝

╔═════════════════════════════════════════╦═════════════════════════════════════════════╗
║                                         ║                                             ║
╚═════════════════════════════════════════╩═════════════════════════════════════════════╝