♠♠♠♠♠♠♠♠♠♠♠♠    ♠♠♠♠♠♠♠♠♠♠♠♠♠♠♠♠▲▲▲▲▲▲▲▲▲▲▲▲▲▲▲▲▲▲▲   ▲▲▲▲▲▲▲▲▲▲▲▲▲▲▲▲▲▲▲  ▲▲▲▲▲▲▲▲▲ ▲▲▲▲
♠♠♠♠♠♠♠♠  ♠♠♠♠♠♠ ♠♠♠♠♠♠♠  ▲▲▲▲▲   ▲▲▲▲▲▲   ▲▲▲▲▲▲▲▲▲▲▲▲▲▲▲▲▲    ▲▲▲▲▲▲▲▲▲▲▲▲  ▲▲▲▲▲▲▲▲▲▲▲
♠♠ ♠♠♠♠ ♠♠♠                   ♠      ▲▲▲▲▲        ▲▲▲▲▲▲▲▲▲   ▲▲▲▲▲   ▲▲▲▲▲▲▲▲▲▲  ▲▲▲▲▲▲▲
♠♠  ♠♠♠♠                                     ♠       ▲▲▲                 ▲▲   ▲▲▲▲▲▲▲  ▲▲
♠♠♠♠♠                 ♠                   ░░░ ░                   ♠        ▲▲▲▲▲▲▲▲▲▲▲▲▲▲
♠♠♠♠♠                                      ░ ░░                                ▲▲▲▲  ▲▲▲▲
♠♠♠♠      ■    ■    ■    ■    ■    ■      ░░░░    ■     ■     ■     ■     ■       ▲▲▲▲▲▲▲
♠♠♠♠      ▒    ▒    ▒    ▒    ▒    ▒       ░░░░   ▒     ▒     ▒     ▒     ▒         ▲▲▲▲▲
♠♠♠   ■  ░░░░ ░░░░  ░░░░░ ░░░░  ░░░ ░░░░ ░░░░░░░░ ░░░░░░ ░░░░░░░ ░░░░░░░░░░░          ▲▲▲
♠♠    ▒     ░░░ ░░░░░░░ ░░░ ░░░░░░ ░░░░░░ ░░░░ ░░░░░░ ░░░░ ░░░ ░░░░░░ ░░░  ░░░░      ▲▲▲▲
♠♠        ▒    ▒    ▒    ▒    ▒    ▒       ░░░    ▒     ▒     ▒     ▒     ▒         ▲▲▲▲▲
♠♠        ■    ■    ■    ■    ■    ■      ░░░░    ■     ■     ■     ■     ■         ▲▲▲▲▲
♠♠♠                                        ░░░                                   ♠   ▲▲▲▲
♠♠♠                                       ░░░ ░                            ♠          ▲▲▲
♠♠♠♠                                       ░░░                                     ♠   ▲▲
▲▄█▄♠♠                                     ░░░                                         ▲▲
▲███♠♠    ■    ■    ■    ■    ■    ■      ░░░░    ■     ■     ■     ■     ■           ♠♠♠
 ▀█▀      ▒    ▒    ▒    ▒    ▒    ▒       ░░ ░   ▒     ▒     ▒     ▒     ▒          ♠♠♠♠
         ░░░░ ░░░░  ░░░░░ ░░░░  ░░░ ░░░░ ░░░░░░░░ ░░░░░░ ░░░░░░░ ░░░░░░░░░░░         ♠ ♠♠
 ▄█▄        ░░░ ░░░░░░░ ░░░ ░░░░░░ ░░░░░░ ░░░░ ░░░░░░ ░░░░ ░░░ ░░░░░░ ░░░  ░░░░       ♠♠♠
▲███      ▒    ▒    ▒    ▒    ▒    ▒      ░░░░    ▒     ▒     ▒     ▒     ▒          ♠♠♠♠
▲▀█▀      ■    ■    ■    ■    ■    ■      ░░░░    ■     ■     ■     ■     ■           ♠♠♠
▲▲                                        ░░░                                      ♠♠  ♠♠
▲▲▲ ▲                                     ░░░                                       ♠♠ ♠♠
♠▲▲                                      ░░░░░                                       ♠♠♠♠
♠♠                                       ░░ ░░                                       ♠ ♠♠
♠         ■    ■    ■    ■    ■    ■      ░░░░    ■     ■     ■     ■     ■           ♠♠♠
▲   ▲     ▒    ▒    ▒    ▒    ▒    ▒     ░░░░     ▒     ▒     ▒     ▒  °  ▒           ♠♠♠
♠▲      ░░░░ ░░░░  ░░░░░ ░░░░  ░░░ ░░░░ ░░░░░░░░ ░░░░░░ ░░░░░░░ ░░░░░░░░░░░          ♠♠ ♠
▲▲▲        ░░░ ░░░░░░░ ░░░ ░░░░░░ ░░░░░░ ░░░░ ░░░░░░ ░░░░ ░░░ ░░░░░░ ░░░  ░░░░     ♠♠♠♠♠♠
▲♠▲▲      ▒    ▒    ▒    ▒    ▒    ▒    ░░░░░     ▒     ▒     ▒     ▒            ▲▲▲  ▲▲▲
▲▲▲▲      ■    ■    ■    ■    ■    ■     ░░░░     ■     ■     ■     ■       ▲▲▲▲▲▲▲▲▲▲▲▲▲
▲  ▲▲▲▲▲▲          ▲                    ░░░░                            ▲▲▲▲▲▲▲▲▲▲   ▲▲▲▲
▲▲  ▲▲▲▲▲▲▲▲▲               ▲            ░░░░░                    ▲▲▲▲▲▲▲▲▲   ▲▲▲▲▲▲▲▲▲▲▲
▲▲▲▲▲♠  ▲▲▲▲▲▲▲▲▲▲▲▲▲▲                  ░░░░░             ▲▲▲▲▲▲▲▲▲▲▲▲   ▲▲▲▲▲▲▲▲▲  ▲▲▲▲▲
▲▲♠▲▲▲▲   ♠♠▲▲▲▲▲▲▲▲▲▲▲▲▲▲▲▲▲▲     ▲     ░░░░    ▲▲▲▲▲▲▲▲▲▲▲▲▲▲▲  ▲▲▲▲▲▲▲▲▲▲▲▲▲▲▲▲  ▲▲▲▲▲
▲▲▲▲▲▲▲▲▲▲▲▲▲▲▲▲▲▲   ▲▲♠♠▲▲▲▲▲▲▲▲▲▲▲▲▲▲ ░░░░ ▲▲▲▲▲▲    ▲▲▲▲▲▲▲▲▲▲▲ ▲▲▲▲▲▲▲▲▲▲   ▲▲▲▲▲▲▲▲▲

╔═════════════════════════════════════════╦═════════════════════════════════════════════╗
║                                         ║                                             ║
╚═════════════════════════════════════════╩═════════════════════════════════════════════╝