▲▲▲▲▲▲▲▲▲▲▲▲▲▲▲▲▲▲▲▲▲▲▲▲▲▲▲▲▲▲▲▲▲▲▲▲▲ ▲▲▲▲▲▲▲▲▲▲▲▲▲▲▲▲▲▲▲▲▲▲▲▲▲▲▲▲▲▲▲▲▲▲  ▲▲▲▲▲▲▲▲▲▲▲▲▲▲▲
▲▲▲▲▲▲▲▲▲▲▲▲▲▲▲▲▲▲▲▲▲▲▲▲▲▲▲▲▲▲▲▲▲▲▲▲▲▲▲▲▲▲▲▲▲▲▲▲▲▲▲▲▲▲▲▲▲▲▲▲▲▲▲▲▲▲▲▲▲▲▲▲▲▲▲▲▲▲▲▲▲▲▲▲▲▲▲▲▲
▲▲ ▲▲▲▲▲▲▲▲▲▲        ▲▲▲▲▲  ♠♠♠♠♠♠♠♠♠♠♠       ▲▲▲▲▲▲▲▲             ▲▲▲▲▲▲▲▲▲▲▲▲▲▲▲▲▲▲▲▲▲▲
▲▲▲▲▲▲ ▲▲▲                     ♠♠♠♠♠♠                                   ▲▲▲▲▲▲▲▲▲▲▲▲▲▲▲▲▲
▲▲▲▲▲▲            ♠              ♠♠♠            ♠                             ▲▲▲▲▲▲▲▲▲▲▲
▲▲▲▲▲ ▲▲                                                                          ▲▲▲▲▲▲▲
▲▲▲▲▲ ▲                                                                             ▲▲▲▲▲
▲▲▲▲                                                                 ♠               ▲▲▲▲
▲▲▲▲                                                                                  ▲▲▲
▲▲▲▲▲                                                                                 ▲▲▲
▲▲▲▲▲      ♠                                                                         ▲▲▲▲
▲▲▲▲                                                                                ▲ ▲▲▲
▲▲▲▲                         ♠                                                     ▲▲  ▲▲
♠▲▲                                                                                 ▲ ▲▲▲
♠♠                                                                                   ▲▲▲▲
♠♠♠                                                                                  ▲▲▲▲
♠♠♠        ♠                                                                     ♠   ▲ ▲▲
♠♠♠♠                                                                                     
♠♠♠♠                                                                                     
♠♠♠  ▲                                                                         ♠    ▲▲   
♠♠♠                                                                                 ▲▲▲▲▲
♠♠        ♠                                                                        ▲▲▲ ▲▲
♠♠♠                                                                                 ▲▲▲▲▲
♠♠♠    ▲                                                                            ▲▲▲ ▲
♠♠♠                                                                        ♠        ▲▲▲▲▲
♠♠♠♠     ♠   ▲                                                                       ▲▲▲▲
♠♠♠♠♠                                                                           ♠    ▲ ▲▲
♠♠♠♠♠                                                                                 ▲▲▲
♠♠♠♠    ♠                                                                    ▲       ▲▲▲▲
♠♠♠ ♠♠♠                                                    ♠                        ▲▲▲▲▲
♠♠♠♠♠♠♠♠    ▲                ♠                                          ♠         ▲▲▲ ▲▲▲
♠♠♠♠ ♠♠♠♠♠                                                         ▲           ▲▲▲▲▲▲▲▲▲▲
♠♠♠♠  ♠♠♠♠♠♠    ▲                                                           ▲▲▲▲▲▲  ▲▲▲▲▲
♠♠♠♠♠♠♠♠♠  ♠♠        ♠                                        ♠         ▲▲▲▲▲   ▲▲▲▲▲▲▲▲▲
♠♠ ♠♠♠♠ ♠♠♠♠♠♠♠♠           ♠              ♠                      ▲▲▲▲▲▲▲▲▲▲▲▲▲▲▲▲▲   ▲▲▲▲
♠♠♠♠♠♠♠  ♠♠♠ ▲▲▲▲▲▲   ▲▲▲▲▲▲▲▲▲▲ ▲▲▲▲              ▲▲▲▲▲▲▲  ▲▲▲▲▲▲▲▲▲▲▲▲▲▲▲     ▲▲▲▲▲▲▲ ▲
▲▲▲♠♠♠♠♠♠ ♠♠♠♠▲▲▲▲▲▲▲▲▲▲▲▲▲▲▲▲▲▲▲▲▲▲▲▲▲▲▲▲▲▲▲▲▲▲▲▲▲▲▲▲▲▲▲▲▲▲▲▲▲▲  ♠▲▲▲▲▲▲▲▲▲▲▲▲▲▲▲♠▲▲▲▲▲▲

╔═════════════════════════════════════════╦═════════════════════════════════════════════╗
║                                         ║                                             ║
╚═════════════════════════════════════════╩═════════════════════════════════════════════╝