╔══════════════════════════════════╡              ╞═════════════════════════════════════╗
║                                                                                       ║
║                                                                                       ║
║                                                                                       ║
║                                                                                       ║
║                                                                                       ║
║                                                                                       ║
║                                                                                       ║
║                                                                                       ║
║                                                                                       ║
║                                                                                       ║
║                                                                                       ║
║                                                                                       ║
║                                                                                       ║
║                                                                                       ║
║                                                                                       ║
║                                                                                       ║
║                                                                                       ║
║                                                                                       ║
║                                                                                       ║
║                                                                                       ║
║                                                                                       ║
║                                                                                       ║
║                                                                                       ║
║                                                                                       ║
║                                                                                       ║
║                                                                                       ║
║                                                                                       ║
║                                                                                       ║
║                                                                                       ║
║                                                                                       ║
║                                                                                       ║
║                                                                                       ║
║                                                                                       ║
║                                                                                       ║
║                                                                                       ║
╚═══════════════════════════════════════════════════════════════════════════════════════╝

╔═════════════════════════════════════════╦═════════════════════════════════════════════╗
║                                         ║                                             ║
╚═════════════════════════════════════════╩═════════════════════════════════════════════╝